15.ox
.o.............
..o......o....o
.........oo..o.
...o...o.......
...o...........
..oxxxxx..o....
...xxxxx....o..
...xxxxx..o....
..oxxxxxo.o...o
...oo...o......
o.......o.....o
...o..o..o..o..
...........o...
...o...........
..o............
