10.ox
.o..o...o.
.....ooo..
..........
..oooo..o.
.o..ooooo.
.o........
o..o...o..
...oo.....
oo.o....oo
o......oo.
