20.ox
...oo...o.oo...o....
..o..oo.....o......o
oo............o..o.o
...o..o.o...o..o.o.o
o..o.......o.o....o.
o.o.o...o.oo.....o..
..oo...o.oo..o......
........o.....o.....
.ooooo......o.o.oo..
..o.oo.o.oo.........
oooo.......o......o.
o.ooo..o..ooo...oo..
..o........o.oo.o...
...o.o..o...........
.........oo...o.....
..o...o......o...o.o
.o.......oooo.o.....
..oo....oo.ooo......
..o....o....oo..o..o
...o..o...........o.
