50.ox
...........o..................o......o.......o....
o............oo....o...........o..oooo.o.........o
.....o.oo.oo...o....ooo.......o..o...o.oo...o....o
.........o.o.o.....oo....oo.....o.........o..o....
.....o.o.................o.....oo.........o.oo.o..
o..o......o.o..o......oo....o....oo.........o....o
....oo....o...o.oo.....................oooo.o....o
...........oo..o........o.o.......................
o...o.....o..o...o....o.o....o.....o..o...........
....o.........o...........oo...o.oo.......o.......
.o.o.......o.......o....o...............o....o....
oo........o.......................oo......o.o.o...
.......oooo....oo....o.oo..o...............o..ooo.
............o...oooo.o...o.o.......oo...o....o..oo
...........o...............................o..oo..
o.....o.....o....o......o.........o.o.o.....o...oo
.o......o..........o.ooooo.....o......o...o....o..
o.....o.o.....o.......o.........o.o...............
.o...o..o....oo......oo...o...............o......o
.o.oo..oo.......o.o....oo.....o...o....o........oo
......o.o....oo........o........o...o..o....o...oo
..................o......oo..o..o..o.o.....ooo....
........o.o.oo.ooo.o..o...o..oo...ooo....o........
o...o.o............ooo..o...o.....o...............
o...o.....oo....o...oo..o...o.o...o...........o...
...oo.........oo.oo.o.o.oo......o.................
.o............o..o.o...o...oo...o..o...o....o.....
o...o..o...o............o..oo...o.o..o...o........
...oo....o...oo......................oo.o.oo......
...........o.o...oo..oo...o.o...o.o.........o..o.o
.....o.....o..........o......o....o.o...o..o.o...o
.......oo...o.o.......ooo.o....o....o.....o..o....
o..........o.o......o........o....oo..............
.o...o.................o.............oo....o..o...
....o...............oo.o..o....o.........o..o.....
.o.....o.oo...o...o.........o..oo................o
.o...o.o....o...oo..o..............o....oo...oo...
........o......o....o...............oo............
......o..o.........o.oo.......oo....o.o..........o
o........o.........o...............o...........o..
...o...o.....o.oo...oo..........o..o...........o..
.o...o......o............o.o.o....o....o..........
.....o..o.....o.o.....o...o.....o..o..............
.....o..o.........o.....o...oo........oo.....o..o.
.o..........o..ooooo..oo.o...o........o..o........
..o.............o........o..o....o.o...oo....oo...
......o.....o........oo..oo.o...oo.....o..o...o.o.
........o......o...o..o.o.......o........o.....o..
...o.oo..o..o...............................o.oo.o
....o...........o...o.........o.oo...o..o..o.o....
