10.ox
..rr.....o
......o...
o.........
..de....o.
.oo....o..
.....o....
o.......o.
....oo.o..
o.........
..........
