101ox
11rr11111o
111111o111
o111111111
11de1111o1
1oo1111o11
11111o1111
o1111111o1
1111oo1o11
o111111111
1111111111
